
R 640 400
NO ./textures/grey.xpm
WE ./textures/blue.xpm
SO ./textures/floor.xpm
EA ./textures/brick.xpm

S ./textures/barrel.xpm


C 205,249,225
F 224,172,105

        1111111111111111111111111
        1022222222112222222222211
        112122221112222222222221
        1221222222222222222222211
111111111211222221112222222222221
122222222211222221112111112111111
11112111111111211122222212211
11112111111111211121212212221
11200000110101011100000010001
10000000000000001100000010001111111111111111111111
10000000000000000001010010N20000000010
11000011110101011111011110001000111010
11110111 1110101 101111010001111111110
11111111 1111111 111111111111000000000

1
1

