
R 300 200
NO ./textures/grey.xpm
SO ./textures/blue.xpm
WE ./textures/floor.xpm
EA ./textures/brick.xpm
S ./textures/barrel.xpm

F 224,172,105
C 205,249,225
1111111111
1000000001
1000000001
1000000001
1000N00011
1111111111
