
R 600 400
NO ./textures/grey.xpm
SO ./textures/blue.xpm
WE ./textures/floor.xpm
EA ./textures/brick.xpm
S ./textures/barrel.xpm

F 224,172,105
C 205,249,225

2
         111111111111111111111111111111111111111111111111111111111111111111
         100020001001010000122221222221222222122222222222222222222222222111
         122212121211222222122221222221222222212121122222222222222222222211
         122222121222212222122221222221222222221222222222222222222222200221
         11222212222121E222222222222222222222222222222222222222222222200111
         1111111111111111111111111111111111111111111111111111111111111111111



