
R 1080 768
NO ./textures/grey.xpm
SO ./textures/blue.xpm
WE ./textures/floor.xpm
EA ./textures/brick.xpm
S ./textures/barrel.xpm

F 224,172,105
C 205,249,225

111111111111111111111111111111111111111111111111111111111111111111
100020001001010000122221222221222222122222222222222222222222222111
122212121211222222122221222221222222212121122222222222222222222211
12222212122221222212222122222122222222122222222222222222222222221
11222212222121E22222222222222222222222222222222222222222222222211
122212121211222222122221222221222222212121122222222222222222222211
12222212122221222212222122222122222222122222222222222222222222221
122212121211222222122221222221222222212121122222222222222222222211
12222212122221222212222122222122222222122222222222222222222222221
122212121211222222122221222221222222212121122222222222222222222211
12222212122221222212222122222122222222122222222222222222222222221
122212121211222222122221222221222222212121122222222222222222222211
12222212122221222212222122222122222222122222222222222222222222221
122212121211222222122221222221222222212121122222222222222222222211
12222212122221222212222122222122222222122222222222222222222222221
122212121211222222122221222221222222212121122222222222222222222211
12222212122221222212222122222122222222122222222222222222222222221
122212121211222222122221222221222222212121122222222222222222222211
12222212122221222212222122222122222222122222222222222222222222221
122212121211222222122221222221222222212121122222222222222222222211
12222212122221222212222122222122222222122222222222222222222222221
122212121211222222122221222221222222212121122222222222222222222211
12222212122221222212222122222122222222122222222222222222222222221
12222212122221222212222122222122222222122222222222222222222222221
122212121211222222122221222221222222212121122222222222222222222211
12222212122221222212222122222122222222122222222222222222222222221
122212121211222222122221222221222222212121122222222222222222222211
12222212122221222212222122222122222222122222222222222222222222221
122212121211222222122221222221222222212121122222222222222222222211
12222212122221222212222122222122222222122222222222222222222222221
122212121211222222122221222221222222212121122222222222222222222211
12222212122221222212222122222122222222122222222222222222222222221
122212121211222222122221222221222222212121122222222222222222222211
12222212122221222212222122222122222222122222222222222222222222221
122212121211222222122221222221222222212121122222222222222222222211
12222212122221222212222122222122222222122222222222222222222222221
122212121211222222122221222221222222212121122222222222222222222211
12222212122221222212222122222122222222122222222222222222222222221
122212121211222222122221222221222222212121122222222222222222222211
12222212122221222212222122222122222222122222222222222222222222221
122212121211222222122221222221222222212121122222222222222222222211
12222212122221222212222122222122222222122222222222222222222222221
122212121211222222122221222221222222212121122222222222222222222211
12222212122221222212222122222122222222122222222222222222222222221
122212121211222222122221222221222222212121122222222222222222222211
12222212122221222212222122222122222222122222222222222222222222221
122212121211222222122221222221222222212121122222222222222222222211
12222212122221222212222122222122222222122222222222222222222222221
122212121211222222122221222221222222212121122222222222222222222211
12222212122221222212222122222122222222122222222222222222222222221
122212121211222222122221222221222222212121122222222222222222222211
12222212122221222212222122222122222222122222222222222222222222221
122212121211222222122221222221222222212121122222222222222222222211
12222212122221222212222122222122222222122222222222222222222222221
122212121211222222122221222221222222212121122222222222222222222211
12222212122221222212222122222122222222122222222222222222222222221
122212121211222222122221222221222222212121122222222222222222222211
12222212122221222212222122222122222222122222222222222222222222221
12222212122221222212222122222122222222122222222222222222222222221
122212121211222222122221222221222222212121122222222222222222222211
12222212122221222212222122222122222222122222222222222222222222221
122212121211222222122221222221222222212121122222222222222222222211
12222212122221222212222122222122222222122222222222222222222222221
122212121211222222122221222221222222212121122222222222222222222211
12222212122221222212222122222122222222122222222222222222222222221
122212121211222222122221222221222222212121122222222222222222222211
12222212122221222212222122222122222222122222222222222222222222221
122212121211222222122221222221222222212121122222222222222222222211
12222212122221222212222122222122222222122222222222222222222222221
122212121211222222122221222221222222212121122222222222222222222211
12222212122221222212222122222122222222122222222222222222222222221
122212121211222222122221222221222222212121122222222222222222222211
12222212122221222212222122222122222222122222222222222222222222221
122212121211222222122221222221222222212121122222222222222222222211
12222212122221222212222122222122222222122222222222222222222222221
122212121211222222122221222221222222212121122222222222222222222211
12222212122221222212222122222122222222122222222222222222222222221
122212121211222222122221222221222222212121122222222222222222222211
12222212122221222212222122222122222222122222222222222222222222221
122212121211222222122221222221222222212121122222222222222222222211
12222212122221222212222122222122222222122222222222222222222222221
122212121211222222122221222221222222212121122222222222222222222211
12222212122221222212222122222122222222122222222222222222222222221
122212121211222222122221222221222222212121122222222222222222222211
12222212122221222212222122222122222222122222222222222222222222221
122212121211222222122221222221222222212121122222222222222222222211
12222212122221222212222122222122222222122222222222222222222222221
122212121211222222122221222221222222212121122222222222222222222211
12222212122221222212222122222122222222122222222222222222222222221
122212121211222222122221222221222222212121122222222222222222222211
12222212122221222212222122222122222222122222222222222222222222221
122212121211222222122221222221222222212121122222222222222222222211
12222212122221222212222122222122222222122222222222222222222222221
12222212122221222212222122222122222222122222222222222222222222221
122212121211222222122221222221222222212121122222222222222222222211
12222212122221222212222122222122222222122222222222222222222222221
122212121211222222122221222221222222212121122222222222222222222211
12222212122221222212222122222122222222122222222222222222222222221
122212121211222222122221222221222222212121122222222222222222222211
12222212122221222212222122222122222222122222222222222222222222221
122212121211222222122221222221222222212121122222222222222222222211
12222212122221222212222122222122222222122222222222222222222222221
122212121211222222122221222221222222212121122222222222222222222211
12222212122221222212222122222122222222122222222222222222222222221
122212121211222222122221222221222222212121122222222222222222222211
12222212122221222212222122222122222222122222222222222222222222221
122212121211222222122221222221222222212121122222222222222222222211
12222212122221222212222122222122222222122222222222222222222222221
122212121211222222122221222221222222212121122222222222222222222211
12222212122221222212222122222122222222122222222222222222222222221
122212121211222222122221222221222222212121122222222222222222222211
12222212122221222212222122222122222222122222222222222222222222221
122212121211222222122221222221222222212121122222222222222222222211
12222212122221222212222122222122222222122222222222222222222222221
122212121211222222122221222221222222212121122222222222222222222211
12222212122221222212222122222122222222122222222222222222222222221
122212121211222222122221222221222222212121122222222222222222222211
12222212122221222212222122222122222222122222222222222222222222221
122212121211222222122221222221222222212121122222222222222222222211
12222212122221222212222122222122222222122222222222222222222222221
122212121211222222122221222221222222212121122222222222222222222211
12222212122221222212222122222122222222122222222222222222222222221
122212121211222222122221222221222222212121122222222222222222222211
12222212122221222212222122222122222222122222222222222222222222221
122212121211222222122221222221222222212121122222222222222222222211
12222212122221222212222122222122222222122222222222222222222222221
122212121211222222122221222221222222212121122222222222222222222211
12222212122221222212222122222122222222122222222222222222222222221
12222212122221222212222122222122222222122222222222222222222222221
122212121211222222122221222221222222212121122222222222222222222211
12222212122221222212222122222122222222122222222222222222222222221
122212121211222222122221222221222222212121122222222222222222222211
12222212122221222212222122222122222222122222222222222222222222221
122212121211222222122221222221222222212121122222222222222222222211
12222212122221222212222122222122222222122222222222222222222222221
122212121211222222122221222221222222212121122222222222222222222211
12222212122221222212222122222122222222122222222222222222222222221
122212121211222222122221222221222222212121122222222222222222222211
12222212122221222212222122222122222222122222222222222222222222221
122212121211222222122221222221222222212121122222222222222222222211
12222212122221222212222122222122222222122222222222222222222222221
122212121211222222122221222221222222212121122222222222222222222211
12222212122221222212222122222122222222122222222222222222222222221
122212121211222222122221222221222222212121122222222222222222222211
12222212122221222212222122222122222222122222222222222222222222221
111111111111111111111111111111111111111111111111111111111111111111
